.....................XX
..............E......XX
.....................XX
.....E...............XX
.....................XX
E....................XX
.....................XX
..........G..........XX
.....................XX
.....................XX
.....................XX
..P..................XX
.....................XX
.....................XX
FFFFFFFFFFFFFFFFFFFFFFF
FFFFFFFFFFFFFFFFFFFFFFF

