FFFFFFFFF...P..FFFFFFFF
...............FF.....X
...............FF.....X
...........FFFFFF.....X
.......FFF...........#F
...........E.........#F
E..FF..............#FFF
......E............#..F
.................F....F
.............F..F.....F
.....#FFF.F...........F
.....#................F
E....#................F
.....#................F
FFFFFFFFFFFFFFFFFFFFFFF
FFFFFFFFFFXXFFFFFFFFFFF

