E........X
.........X
....G....X
.........X
.........X
P........X
FFFFFFFFFF
