FFF............FFFFFFFF
......................F
......................F
.....E................F
..........FFF.........F
........FFFFF.........X
.......FFFFFF.........X
......FFFFFFF.........X
##FFFFFFFFFFFFFFFFFFFFF
##....................F
##E...................F
##....................F
##E.................P.F
##....................F
FFFFFFFFFFFFFFFFFFFF##F
FFFFFFFFFFFFFFFFFFFF##F

