.....................FF
.....................FF
.....................FF
.....................FF
.....................FF
.....................FF
.................FFFFFF
.....................FF
.....................XX
..P..................XX
.....................XX
..............FFFFFFFFF
..........FFFFFFFFFFFFF
.......FFFFFFFFFFFFFFFF
FFFFFFFFFFFFFFFFFFFFFFF
FFFFFFFFFFFFFFFFFFFFFFF

