......................X
......................X
......................X
......................X
......................X
..........G...........X
......................X
......................X
......................X
......................X
......................X
..P...................X
......................X
......................X
FFFFFFFFFFFFFFFFFFFFFFF
FFFFFFFFFFFFFFFFFFFFFFF
