E........X
.........X
....G....X
.........X
.P.......X
.........X
FFFFFFFFFF
