E........X
.........X
....G....X
.P.......X
.........X
.........X
FFFFFFFFFF
