FFFFFFFFFFFFFFFFFFFFFFF
................FFFFFFF
......E.............FFF
......................F
......................F
......................F
.P....................F
...............FFF....F
................FF....F
........FFFF.....F....X
.................F....X
FFFFFF...........F....X
FFFFFF...........F....X
FFFFFF...........F....X
FFFFFF.........FFFFFFFF
FFF.FF.........FFFFFFFF

