......................X
......................X
......................X
......................X
......................X
......................X
......................X
.....................FF
.................FFFFFF
..P..........FFFFFFFFFF
.........FFFFFFFFFFFFFF
.......FFFF..........FF
.......FFFF..........FF
.......FFFF..........FF
FFFFFFFFFFFFFFFFFFFFFFF
FFFFFFFFFFFFFFFFFFFFFFF

