FFFFFFFFFFFFFFFFFFFFFFF
....F.................F
....F.................F
....F.................F
....F.E...............F
.P..F.................F
....F.E...............F
....F.................F
FF.#FFF.#FFFFFFFF#....F
...#....#F.......#....F
..E#....#F.......#....F
........#F....E..#....F
..E.....#F##F#...#....F
........#F##F#...#....F
FFFFFFFFFF##FFFFFFFFFFF
FFFFFFFFFFXXFFFFFFFFFFF

