..P..................FX
.....................FF
....................FFF
..................FFFFX
...............FFFFFFFX
FFFFF.........FFFFF...X
.............FF.......X
E...........FF........X
.........FFFF.........X
........FF............X
E.....................X
......................X
E.....................X
......................X
...............FFFFFFFX
FFFFFFFFFFFFFFFFFFFFFFF

