FFFFFFFFFFFFFFFFFFFFFFF
......................F
..E...................F
......................F
......................F
......................F
......................F
................FF....F
..P.............FF....F
..........FF.....F....X
.................F....X
FFFFFF...........F....X
FFFFFF...........F....X
FFFFFF...........F....X
FFFFFF.........FFFFFFFF
FFF.FF.........FFFFFFFF

