E........X
.........X
....G....X
....FFF..X
.P.......X
.........X
FFFFFFFFFF
