
.........X
.........X
....G....X
.....S...X
P........X
....FFF..X
FFFFFFFFFF
