
......................X
......................X
......................X
......................X
......................X
..........G...........X
......................X
......................X
.............S........X
..P...................X
......................X
......................X
........FFFFFFFFFF....X
........FFFFFFFFFF....X
FFFFFFFFFFFFFFFFFFFFFFF
FFFFFFFFFFFFFFFFFFFFFFF
