
......................X
......................X
......................X
......................X
......................X
..........G...........X
......................X
......................X
.............S........X
......................X
......................X
..P........FFFFF......X
.........FFFFFFFF.....X
........FFFFFFFFFF....X
FFFFFFFFFFFFFFFFFFFFFFF
FFFFFFFFFFFFFFFFFFFFFFF
